{
  "width": 320,
  "height": 240,
  "offsetX": 0,
  "offsetY": 0,
  "layers": [
    {
      "name": "tiles",
      "_eid": "37713875",
      "offsetX": 0,
      "offsetY": 0,
      "gridCellWidth": 16,
      "gridCellHeight": 16,
      "gridCellsX": 20,
      "gridCellsY": 15,
      "tileset": "tileset",
      "data2D": [
        [1, 0, 2, 2, 0, 2, 2, 1, 1, 2, 2, 2, 0, 0, 1, 1, 0, 2, 2, 0],
        [0, 1, 0, 0, 1, 1, 1, 1, 0, 1, 0, 1, 0, 1, 2, 2, 1, 0, 0, 2],
        [2, 0, 0, 0, 1, 1, 2, 0, 1, 0, 2, 1, 2, 1, 2, 0, 2, 1, 2, 1],
        [0, 1, 1, 1, 0, 2, 1, 0, 1, 1, 1, 0, 0, 2, 0, 0, 0, 0, 0, 0],
        [2, 2, 0, 0, 1, 0, 2, 0, 1, 1, 2, 0, 1, 2, 1, 1, 0, 0, 2, 1],
        [1, 0, 0, 1, 1, 2, 2, 1, 0, 0, 2, 1, 1, 0, 2, 2, 0, 2, 0, 2],
        [1, 1, 0, 2, 1, 1, 0, 2, 2, 0, 0, 1, 1, 0, 1, 2, 2, 0, 2, 1],
        [0, 0, 2, 0, 0, 2, 2, 0, 0, 1, 2, 0, 1, 1, 1, 1, 2, 2, 2, 0],
        [1, 1, 2, 2, 0, 2, 1, 1, 2, 2, 0, 1, 2, 1, 1, 0, 1, 1, 2, 1],
        [0, 0, 0, 2, 0, 0, 2, 1, 0, 1, 1, 2, 0, 2, 0, 1, 2, 0, 2, 1],
        [2, 1, 1, 1, 0, 0, 1, 1, 2, 1, 0, 2, 2, 1, 2, 1, 2, 1, 1, 2],
        [1, 0, 1, 0, 0, 0, 2, 1, 0, 2, 2, 2, 1, 2, 1, 2, 1, 2, 0, 0],
        [0, 0, 1, 0, 1, 2, 2, 0, 0, 1, 2, 2, 1, 0, 1, 2, 0, 1, 0, 1],
        [0, 0, 1, 0, 1, 2, 1, 0, 0, 0, 2, 2, 2, 1, 2, 0, 0, 2, 2, 1],
        [0, 0, 0, 2, 1, 1, 2, 1, 2, 1, 1, 2, 0, 2, 0, 2, 0, 2, 2, 0]
      ],
      "exportMode": 0,
      "arrayMode": 1
    }
  ]
}